########***
#a.....#***
#...@..#***
#......####
#b.....A..B
####.######
####.######
####.######
####.....##
###########
