#####.##***#######
#a..<..#***#...<.#
#...@..#***#.....#
#......#####.....#
#......A.........#
####.###########.#
####.######......#
####.######......#
####.............#
###########......#
###########......#
##################