########***#######
#a.....#***#...<.#
#~~.@..#***#.....#
#......#####.....#
#......A.........#
####.###########.#
####.######.~....#
####.######.~....#
####.........~~..#
###########~.~...#
###########....~.#
##################